0 0 0 0 0 0 0 0 10 10 0  0  0  0  0  0  0  0  0  0  0  0  0  0  0  0  0  0  0  0  0  0  0  0  0  0  0  0  0  0  0  0  0  0  0  0  0  0  0  0  0  0  0  0  0  0  0  0  0  0  0  0  0  0  0  0  0  0  0  0  0  0  10 10 0 0 0 0 0 0 0 0
0 0 0 0 0 0 0 0 10 10 0  0  0  0  0  0  0  0  0  0  0  0  0  0  0  0  0  0  0  0  0  0  0  0  0  0  0  0  0  0  0  0  0  0  0  0  0  0  0  0  0  0  0  0  0  0  0  0  0  0  0  0  0  0  0  0  0  0  0  0  0  0  10 10 0 0 0 0 0 0 0 0
0 0 0 0 0 0 0 0 10 10 0  0  0  0  0  0  0  0  0  0  0  0  0  0  0  0  0  0  0  0  0  0  0  0  0  0  0  0  0  0  0  0  0  0  0  0  0  0  0  0  0  0  0  0  0  0  0  0  0  0  0  0  0  0  0  0  0  0  0  0  0  0  10 10 0 0 0 0 0 0 0 0
0 0 0 0 0 0 0 0 10 10 0  0  0  0  0  0  0  0  0  0  0  0  0  0  0  0  0  0  0  0  0  0  0  0  0  0  0  0  0  0  0  0  0  0  0  0  0  0  0  0  0  0  0  0  0  0  0  0  0  0  0  0  0  0  0  0  0  0  0  0  0  0  10 10 0 0 0 0 0 0 0 0
0 0 0 0 0 0 0 0 10 10 0  0  0  0  0  0  0  0  0  0  0  0  0  0  0  0  0  0  0  0  0  0  0  0  0  0  0  0  0  0  0  0  0  0  0  0  0  0  0  0  0  0  0  0  0  0  0  0  0  0  0  0  0  0  0  0  0  0  0  0  0  0  10 10 0 0 0 0 0 0 0 0
0 0 0 0 0 0 0 0 10 10 0  0  0  9  0  0  0  0  0  0  0  0  0  0  0  0  0  0  0  0  0  0  0  9  0  0  0  0  0  0  0  0  0  0  0  0  0  0  0  0  0  4  0  0  0  0  0  0  0  0  0  0  0  0  0  0  0  0  0  0  0  0  10 10 0 0 0 0 0 0 0 0
0 0 0 0 0 0 0 0 10 10 0  0  0  0  0  0  0  4  0  0  0  0  0  0  0  0  0  0  0  4  0  0  0  0  0  0  0  0  0  0  0  0  0  0  0  0  0  0  0  0  0  0  0  0  0  0  15 0  0  0  0  0  0  0  0  0  0  0  0  0  0  0  10 10 0 0 0 0 0 0 0 0
0 0 0 0 0 0 0 0 10 10 0  0  0  0  0  0  0  0  0  0  0  12 0  0  0  0  9  0  0  0  0  0  0  0  0  0  0  0  0  0  0  0  15 15 0  0  0  0  0  0  0  0  0  0  0  15 8  15 0  0  0  0  0  0  0  0  0  0  0  0  0  0  10 10 0 0 0 0 0 0 0 0
0 0 0 0 0 0 0 0 10 10 0  0  0  0  0  0  0  0  0  4  0  11 0  0  0  0  0  0  0  0  0  0  0  0  0  0  0  0  0  5  15 15 8  8  15 15 15 15 15 15 15 15 15 15 15 8  8  8  15 15 15 15 15 15 15 15 15 15 15 0  0  0  10 10 0 0 0 0 0 0 0 0
0 0 0 0 0 0 0 0 10 10 1  2  1  1  1  3  1  1  13 1  1  1  1  14 2  1  1  1  1  1  1  1  1  1  3  1  1  1  13 8  8  8  8  8  8  8  8  8  8  8  8  8  8  8  8  8  8  8  8  8  8  8  8  8  8  8  8  8  8  0  0  0  10 10 0 0 0 0 0 0 0 0
0 0 0 0 0 0 0 0 10 10 7  7  7  7  7  7  7  7  7  7  7  7  7  7  7  7  7  7  7  7  7  7  7  7  7  7  7  7  7  7  7  7  7  7  7  7  7  7  7  7  7  7  7  7  7  7  7  7  7  7  7  7  7  7  7  7  7  7  7  0  0  0  10 10 0 0 0 0 0 0 0 0
0 0 0 0 0 0 0 0 10 10 0  0  0  0  0  0  0  0  0  0  0  0  0  0  0  0  0  0  0  0  0  0  0  0  0  0  0  0  0  0  0  0  0  0  0  0  0  0  0  0  0  0  0  0  0  0  0  0  0  0  0  0  0  0  0  0  0  0  0  0  0  0  10 10 0 0 0 0 0 0 0 0
0 0 0 0 0 0 0 0 10 10 0  0  0  0  0  0  0  0  0  0  0  0  0  0  0  0  0  0  0  0  0  0  0  0  0  0  0  0  0  0  0  0  0  0  0  0  0  0  0  0  0  0  0  0  0  0  0  0  0  0  0  0  0  0  0  0  0  0  0  0  0  0  10 10 0 0 0 0 0 0 0 0
0 0 0 0 0 0 0 0 10 10 0  0  0  9  0  0  0  0  0  0  0  0  0  0  0  0  0  0  0  0  0  0  0  9  0  0  0  0  0  0  0  0  0  0  0  0  0  0  0  0  0  0  0  0  0  0  0  0  0  0  0  0  0  0  0  0  0  0  0  0  0  0  10 10 0 0 0 0 0 0 0 0
0 0 0 0 0 0 0 0 10 10 0  0  0  0  0  0  0  4  0  0  0  0  0  0  0  0  0  0  0  4  0  0  0  0  0  0  0  0  0  0  0  0  0  0  0  0  0  0  0  0  0  0  0  0  4  0  0  0  0  0  0  0  0  0  0  0  0  0  0  0  0  0  10 10 0 0 0 0 0 0 0 0
0 0 0 0 0 0 0 0 10 10 0  0  0  0  0  0  0  0  0  0  0  0  0  0  0  0  9  0  0  0  0  0  0  0  0  0  0  0  0  0  0  0  0  0  4  0  0  0  0  0  0  0  0  0  0  0  0  0  0  0  0  4  0  0  0  0  0  4  0  0  0  0  10 10 0 0 0 0 0 0 0 0
0 0 0 0 0 0 0 0 10 10 0  0  0  0  0  0  0  0  0  0  0  0  0  0  0  0  0  0  0  0  12 0  0  0  0  0  0  0  0  0  0  0  0  0  0  0  0  0  0  0  0  0  0  0  0  0  0  0  0  0  0  0  0  0  0  0  0  0  0  0  0  0  10 10 0 0 0 0 0 0 0 0
0 0 0 0 0 0 0 0 10 10 0  0  0  0  0  0  0  0  0  5  15 15 6  0  0  0  0  0  0  0  11 0  0  0  0  0  0  0  0  4  0  0  0  0  0  0  0  0  0  0  0  0  0  0  0  0  0  0  0  5  15 15 15 15 15 15 15 15 15 15 15 15 10 10 0 0 0 0 0 0 0 0
0 0 0 0 0 0 0 0 10 10 0  0  0  1  1  3  1  1  13 8  8  8  8  14 2  1  1  1  1  1  1  1  1  1  3  1  1  1  1  1  1  1  1  1  1  1  1  1  1  1  1  1  1  1  1  1  1  1  13 8  8  8  8  8  8  8  8  8  8  8  8  8  10 10 0 0 0 0 0 0 0 0
0 0 0 0 0 0 0 0 10 10 0  0  0  7  7  7  7  7  7  7  7  7  7  7  7  7  7  7  7  7  7  7  7  7  7  7  7  7  7  7  7  7  7  7  7  7  7  7  7  7  7  7  7  7  7  7  7  7  7  7  7  7  7  7  7  7  7  7  7  7  7  7  10 10 0 0 0 0 0 0 0 0
0 0 0 0 0 0 0 0 10 10 0  0  0  0  0  0  0  0  0  0  0  0  0  0  0  0  0  0  0  0  0  0  0  0  0  0  0  0  0  0  0  0  0  0  0  0  0  0  0  0  0  0  0  0  0  0  0  0  0  0  0  0  0  0  0  0  0  0  0  0  0  0  10 10 0 0 0 0 0 0 0 0
0 0 0 0 0 0 0 0 10 10 0  0  0  0  0  0  0  0  0  0  0  0  0  0  0  0  0  0  0  0  0  0  0  0  0  0  0  0  0  0  0  0  0  0  0  0  0  0  0  0  0  0  0  0  0  0  0  0  0  0  0  0  0  0  0  0  0  0  0  0  0  0  10 10 0 0 0 0 0 0 0 0
0 0 0 0 0 0 0 0 10 10 0  0  0  9  0  0  0  0  0  0  0  0  0  0  0  0  0  0  0  0  0  0  0  9  0  0  0  0  0  0  0  0  0  0  0  0  0  0  0  0  0  0  0  0  0  0  0  0  0  0  0  0  0  0  0  0  0  0  0  0  0  0  10 10 0 0 0 0 0 0 0 0
0 0 0 0 0 0 0 0 10 10 0  0  0  0  0  0  0  4  0  0  0  0  0  0  0  0  0  0  0  4  0  0  0  0  0  0  0  0  0  0  0  0  0  0  0  0  0  0  0  0  0  0  0  0  4  0  0  0  0  0  0  0  0  0  0  0  0  0  0  0  0  0  10 10 0 0 0 0 0 0 0 0
0 0 0 0 0 0 0 0 10 10 0  0  0  0  0  0  0  0  0  0  0  0  0  0  0  0  9  0  0  0  0  12 0  0  0  0  0  0  0  0  0  0  0  0  0  0  0  0  0  0  0  0  0  0  0  0  0  0  0  0  0  0  0  0  0  0  0  0  0  0  0  0  10 10 0 0 0 0 0 0 0 0
0 0 0 0 0 0 0 0 10 10 0  0  0  0  0  0  0  0  0  5  15 15 15 15 15 15 15 6  0  0  0  11 0  0  0  0  0  0  0  5  15 15 15 15 15 15 15 15 15 15 15 15 15 15 15 15 15 15 15 15 15 15 15 15 15 15 15 15 15 0  0  0  10 10 0 0 0 0 0 0 0 0
0 0 0 0 0 0 0 0 10 10 1  2  1  1  1  3  1  1  13 8  8  8  8  8  8  8  8  8  14 1  1  1  1  1  3  1  1  1  13 8  8  8  8  8  8  8  8  8  8  8  8  8  8  8  8  8  8  8  8  8  8  8  8  8  8  8  8  8  8  0  0  0  10 10 0 0 0 0 0 0 0 0
0 0 0 0 0 0 0 0 10 10 7  7  7  7  7  7  7  7  7  7  7  7  7  7  7  7  7  7  7  7  7  7  7  7  7  7  7  7  7  7  7  7  7  7  7  7  7  7  7  7  7  7  7  7  7  7  7  7  7  7  7  7  7  7  7  7  7  7  7  0  0  0  10 10 0 0 0 0 0 0 0 0
0 0 0 0 0 0 0 0 10 10 0  0  0  0  0  0  0  0  0  0  0  0  0  0  0  0  0  0  0  0  0  0  0  0  0  0  0  0  0  0  0  0  0  0  0  0  0  0  0  0  0  0  0  0  0  0  0  0  0  0  0  0  0  0  0  0  0  0  0  0  0  0  10 10 0 0 0 0 0 0 0 0
0 0 0 0 0 0 0 0 10 10 0  0  0  0  0  0  0  0  0  0  0  0  0  0  0  0  0  0  0  0  0  0  0  0  0  0  0  0  0  0  0  0  0  0  0  0  0  0  0  0  0  0  0  0  0  0  0  0  0  0  0  0  0  0  0  0  0  0  0  0  0  0  10 10 0 0 0 0 0 0 0 0
0 0 0 0 0 0 0 0 10 10 0  0  0  9  0  0  0  0  0  0  0  0  0  0  0  0  0  0  0  0  0  0  0  9  0  0  0  0  0  0  0  0  0  0  0  0  0  0  0  0  0  0  0  0  0  0  0  0  0  0  0  0  0  0  0  0  0  0  0  0  0  0  10 10 0 0 0 0 0 0 0 0
0 0 0 0 0 0 0 0 10 10 0  0  0  0  0  0  0  4  0  0  0  0  0  0  0  0  0  0  0  4  0  0  0  0  0  0  0  0  0  0  0  0  0  0  0  0  0  0  0  0  0  0  0  0  4  0  0  0  0  0  0  0  0  0  0  0  0  0  0  0  0  0  10 10 0 0 0 0 0 0 0 0
0 0 0 0 0 0 0 0 10 10 0  0  0  0  0  0  0  0  0  0  0  0  0  0  0  0  9  0  0  0  0  0  0  0  0  0  0  0  0  0  0  12 0  0  0  0  0  0  0  0  0  0  0  0  0  0  0  0  0  0  0  0  12 0  0  0  0  0  0  0  0  0  10 10 0 0 0 0 0 0 0 0
0 0 0 0 0 0 0 0 10 10 0  0  0  0  0  0  0  0  0  0  0  0  0  0  0  0  0  0  0  0  0  0  0  0  0  0  0  0  0  0  0  11 0  0  0  0  0  0  0  0  0  0  0  0  0  0  0  0  0  0  0  0  11 0  0  0  0  0  0  0  0  0  10 10 0 0 0 0 0 0 0 0
0 0 0 0 0 0 0 0 10 10 0  0  1  1  1  3  1  1  1  2  1  1  1  1  2  1  1  1  1  1  1  1  1  1  3  1  1  1  13 8  8  8  8  8  8  8  8  8  8  8  8  8  8  8  8  8  8  8  8  8  8  8  8  8  8  8  8  8  8  8  8  8  10 10 0 0 0 0 0 0 0 0
0 0 0 0 0 0 0 0 10 10 0  0  7  7  7  7  7  7  7  7  7  7  7  7  7  7  7  7  7  7  7  7  7  7  7  7  7  7  7  7  7  7  7  7  7  7  7  7  7  7  7  7  7  7  7  7  7  7  7  7  7  7  7  7  7  7  7  7  7  7  7  7  10 10 0 0 0 0 0 0 0 0
0 0 0 0 0 0 0 0 10 10 0  0  0  0  0  0  0  0  0  0  0  0  0  0  0  0  0  0  0  0  0  0  0  0  0  0  0  0  0  0  0  0  0  0  0  0  0  0  0  0  0  0  0  0  0  0  0  0  0  0  0  0  0  0  0  0  0  0  0  0  0  0  10 10 0 0 0 0 0 0 0 0
0 0 0 0 0 0 0 0 10 10 0  0  0  0  0  0  0  0  0  0  0  0  0  0  0  0  0  0  0  0  0  0  0  0  0  0  0  0  0  0  0  0  0  0  0  0  0  0  0  0  0  0  0  0  0  0  0  0  0  0  0  0  0  0  0  0  0  0  0  0  0  0  10 10 0 0 0 0 0 0 0 0
0 0 0 0 0 0 0 0 10 10 0  0  0  9  0  0  0  0  0  0  0  0  0  0  0  0  0  0  0  0  0  0  0  9  0  0  0  0  0  0  0  0  0  0  0  0  0  0  0  0  0  0  0  0  0  0  0  0  0  0  0  0  0  0  0  0  0  0  0  0  0  0  10 10 0 0 0 0 0 0 0 0
0 0 0 0 0 0 0 0 10 10 0  0  0  0  0  0  0  4  0  0  0  0  0  0  0  0  0  0  0  4  0  0  0  0  0  0  0  0  0  0  0  0  0  0  0  0  0  0  0  0  0  0  0  0  4  0  0  0  0  0  0  12 0  0  0  0  0  0  0  0  0  0  10 10 0 0 0 0 0 0 0 0
0 0 0 0 0 0 0 0 10 10 0  0  0  0  0  0  0  0  0  0  0  0  0  0  0  0  9  0  0  0  0  0  0  0  0  0  0  0  0  0  0  0  0  0  0  0  0  0  0  0  0  0  0  0  0  0  0  0  0  0  0  11 0  0  0  0  0  0  0  0  0  0  10 10 0 0 0 0 0 0 0 0
0 0 0 0 0 0 0 0 10 10 0  0  0  0  0  0  0  0  0  5  15 15 6  0  0  0  0  0  0  0  0  0  0  0  0  0  0  0  0  5  15 15 15 15 15 15 15 15 15 15 15 15 15 15 15 15 15 15 15 15 15 15 15 15 15 15 15 15 15 0  0  0  10 10 0 0 0 0 0 0 0 0
0 0 0 0 0 0 0 0 10 10 1  2  1  1  1  3  1  1  13 8  8  8  8  14 2  1  1  1  1  1  1  1  1  1  3  1  1  1  13 8  8  8  8  8  8  8  8  8  8  8  8  8  8  8  8  8  8  8  8  8  8  8  8  8  8  8  8  8  8  0  0  0  10 10 0 0 0 0 0 0 0 0
0 0 0 0 0 0 0 0 10 10 7  7  7  7  7  7  7  7  7  7  7  7  7  7  7  7  7  7  7  7  7  7  7  7  7  7  7  7  7  7  7  7  7  7  7  7  7  7  7  7  7  7  7  7  7  7  7  7  7  7  7  7  7  7  7  7  7  7  7  0  0  0  10 10 0 0 0 0 0 0 0 0
0 0 0 0 0 0 0 0 10 10 0  0  0  0  0  0  0  0  0  0  0  0  0  0  0  0  0  0  0  0  0  0  0  0  0  0  0  0  0  0  0  0  0  0  0  0  0  0  0  0  0  0  0  0  0  0  0  0  0  0  0  0  0  0  0  0  0  0  0  0  0  0  10 10 0 0 0 0 0 0 0 0
0 0 0 0 0 0 0 0 10 10 0  0  0  0  0  0  0  0  0  0  0  0  0  0  0  0  0  0  0  0  0  0  0  0  0  0  0  0  0  0  0  0  0  0  0  0  0  0  0  0  0  0  0  0  0  0  0  0  0  0  0  0  0  0  0  0  0  0  0  0  0  0  10 10 0 0 0 0 0 0 0 0
0 0 0 0 0 0 0 0 10 10 0  0  0  9  0  0  0  0  0  0  0  0  0  0  0  0  0  0  0  0  0  0  0  9  0  0  0  0  0  0  0  0  0  0  0  0  0  0  0  0  0  0  0  0  0  0  0  0  0  0  0  0  0  0  0  0  0  0  0  0  0  0  10 10 0 0 0 0 0 0 0 0
0 0 0 0 0 0 0 0 10 10 0  0  0  0  0  0  0  4  0  0  0  0  0  0  0  0  0  0  0  4  0  0  0  0  0  0  0  0  0  0  0  0  0  0  0  0  0  0  0  0  0  0  0  0  4  0  0  0  0  0  0  0  0  0  0  0  0  0  0  0  0  0  10 10 0 0 0 0 0 0 0 0
0 0 0 0 0 0 0 0 10 10 0  0  0  12 0  0  0  0  0  0  0  0  0  0  0  0  9  0  0  0  0  0  0  0  0  0  0  0  0  0  0  0  0  0  0  0  0  0  0  0  0  0  0  0  0  0  0  0  0  0  0  0  0  0  0  0  0  0  0  0  0  0  10 10 0 0 0 0 0 0 0 0
0 0 0 0 0 0 0 0 10 10 0  0  0  11 0  0  0  0  0  0  0  0  0  0  0  0  0  0  0  0  0  0  0  0  0  0  0  0  0  0  0  0  0  0  0  0  0  0  0  0  0  0  0  0  0  0  0  0  0  0  0  0  0  0  0  0  0  0  0  0  0  0  10 10 0 0 0 0 0 0 0 0
0 0 0 0 0 0 0 0 10 10 15 15 15 15 15 15 15 15 15 15 15 15 6  0  0  0  0  0  0  0  0  0  0  0  0  0  0  0  0  5  0  0  0  0  0  0  0  0  0  0  0  0  0  0  0  0  0  0  0  0  0  0  0  0  0  0  0  5  15 15 15 15 10 10 0 0 0 0 0 0 0 0
0 0 0 0 0 0 0 0 10 1  8  8  8  8  8  8  8  8  8  8  8  8  8  14 2  1  1  1  1  1  1  1  1  1  3  1  1  1  1  1  2  3  1  1  1  1  3  1  1  1  1  3  1  1  1  1  3  1  1  1  1  3  1  1  1  1  13 8  8  8  8  8  10 10 0 0 0 0 0 0 0 0
0 0 0 0 0 0 0 0 10 7  7  7  7  7  7  7  7  7  7  7  7  7  7  7  7  7  7  7  7  7  7  7  7  7  7  7  7  7  7  7  7  7  7  7  7  7  7  7  7  7  7  7  7  7  7  7  7  7  7  7  7  7  7  7  7  7  7  7  7  7  7  7  10 10 0 0 0 0 0 0 0 0